                                                                                    %+ +      %                                                                                                                        !!!!
                       #                                                            ----------   ---#                &              ---     -##-                                                                       !!!!
                                                                                                                                                                                                              ---      !!!!
                                                                                                                                                                                                             ----      !!!!
                 #   -&-#-                        -           -                   -&-                                                                  -  -           --   -                                -----      !!!!
                                          -       -           -                                    #       -#     #  #  #        -           --       --  --         ---   --             --#-             ------      !!!!
                               ^          -       -           -                                                                                      ---  ---       ----   ---      -                     -------      !!!!
%  *                   +       -          -+      -     + +   -                               %         + +         =       + +         + +  + +    ----  ----     -----   ----     -              + +   --------      !!!!
-------------------------------------------------------------------------   ----------------   -------------------------------------------------------------------------   -------------------------------------------------
-------------------------------------------------------------------------   ----------------   -------------------------------------------------------------------------   -------------------------------------------------