                                                                                    %+ +      %                                                                                                                        !!!
                       #                                                            ----------   ---#                #              ---     -##-                                                                       !!!
                                                                                                                                                                                                              ---      !!!
                                                                                                                                                                                                             ----      !!!
                 #   -#-#-                        -           -                   -#-                                                                  -  -           --   -                                -----      !!!
                                          -       -           -                                    #       -#     #  #  #        -           --       --  --         ---   --             --#-             ------      !!!
                               ^          -       -           -                                                                                      ---  ---       ----   ---      -                     -------      !!!
%  *                   +       -          -+      -     + +   -                               %         + +         =       + +         + +  + +    ----  ----     -----   ----     -              + +   --------      !!!
-------------------------------------------------------------------------   ----------------   -------------------------------------------------------------------------   -------------------------------------------------
-------------------------------------------------------------------------   ----------------   -------------------------------------------------------------------------   -------------------------------------------------