                                                                                    %+ +      %                                                                                                                        !
                       #                                                            ----------   ---#                #              ---     -##-                                                                       !
                                                                                                                                                                                                              ---      !
                                                                                                                                                                                                             ----      !
                 #   -#-#-                        -           -                   -#-                                                                  -  -           --   -                                -----      !
                                          -       -           -                                    #       -#     #  #  #        -           --       --  --         ---   --             --#-             ------      !
                               -          -       -           -                                                                                      ---  ---       ----   ---      -                     -------      !
%  *                   +       -          -+      -     + +   -                               %         + +         =       + +         + +  + +    ----  ----     -----   ----     -              + +   --------      !
-------------------------------------------------------------------------  -----------------   -------------------------------------------------------------------------   -------------------------------------------------
-------------------------------------------------------------------------  -----------------   -------------------------------------------------------------------------   -------------------------------------------------