                                                                                                         %+ +      %                                                                                                                        !!!!
                                            #                                                             wwwwwwwww    www#               &              www     w##w                                                                       !!!!
                                                                                                                                                                                                                                   ---      !!!!
                                                                                                                                                                                                                                  ----      !!!!
                                      #   w&w#w                        w           w                   w&w                                                                  -  -           --   -                                -----      !!!!
                                                               w       w           w                                    #       w#     #  #  #        w           ww       --  --         ---   --             ww#w             ------      !!!!
                                                    ^          w       w           w                                                                                      ---  ---       ----   ---      w                     -------      !!!!
                     %         *            +       w          w+      w     + +   w                               %         + +         =       + +         + +  + +    ----  ----     -----   ----     w              + +   --------      !!!!
------------------------------------------------------------------------------------------    ------------------    -------------------------------------------------------------------------   -----------------------------------------------------------